0000000001111111122222222222222222222222222222222000000000000002
0000000001111111122222222222222222222222222222222000000000000022
0000000001111111122222222222222222222222222222222200000000000222
0000000001111111122222222222222222222222222222222220000000002222
0000000011111111222222222222222222222222222222222220000000022222
0000000111111111222222222222222222222222222222222220000000022222
0000001111111112222222222222222222222222222222222222000000022222
0001111111111122222222222222222222222222222222222222200000222222
0011111111111222222222222222222222222222222222222222222222222222
0111111111112222222222222222222222222111112222222222222222222222
1111111111122222222222222222111111111111111122222222222222222222
1111111111222222222222222111111111111111111111222222222222222222
1111111112222222222222221111111111111111111111112222221111222222
1111111112222222222222211111111100111111111111001111111111111222
1111111122222222220022111111111100111111111111001111111111111112
1111111122222222200001111111111111111111001111111111111111111111
0111111122222222000001111001111111111111001111111111000111000011
0011111122222220000001111001111111111111111111111111000111000011
0011111122222220000001111111111111111111111111111111000111000011
0011111111222220000001111111111110011111111111111111111111000011
0011111111122220000000111111111110011111111111111111111111000011
0001111111122222000000111111111111111122211111110000000111000011
0001111111122222222001111111111111111222222211110111110111000011
0001111111122222222222111111111111112222222222211111110111000011
0011111111122222222222221111111111112222222222220111110111000011
1111111111122222222222222221011011222222222222220111110111111111
1111111111222222222222222222011022222222222222220001000111111111
1111111111222222222222222222011022222222222222222211111111111111
2221111112222000002222222222011022222222222222222211111111111111
2222211122222000000222222222011022222222222222222221111111111111
2222222222220000000022222221011011222222222222222222111111111111
2222222222200000000022222211111111112222222222222222111111111111
2222222222200000000022222211111111111222222222222222111111111100
2222222222200000000022222211111111111122222222222221111111111000
2222222222220000000022222211111111111112222222222221111111110000
2222222222222200000222222211111111111112222222222111111111100000
2222222222222222222222222211111111111111000222221111111111000000
2222222222222222222222222211111111111110000002111111111111000000
2222222222222222222222222111111111111100000001111110011111000000
2222222222222222222222211111111111111000000000111100001111000000
2222222222222111111111111111111111110000000000011100001111000000
2222222222221111111111111111111111110001110111011110011111000000
2222222222211111111111111111111111111001010001011111111111100000
2222222222211111111111111111111111111111010111011111111111100000
2222222222111100000111111111111111111000010100001111111111110000
2222222222111100000111111111111111110001110111111111111111112200
2222222222111100000111111111111111110001000100001111100111122222
2222222222111100000110000011111111110001110100011111000011222222
2222222222111100000110000011111111111001000100111111000011222222
2222222222111111111110000011111111111001111100111111100111222222
2222222222211111111110000011111111111100000000111111111111222222
2222222222221111111111111111111122111110000002111111111112222222
2222222002222111111111111111111222222110000222211111111122222222
2222220000222211111111111111112222222222222222222222222222222222
2222220000022222222111111111222222222222222222222222222222222222
2222222000002222222222222222222222222222222222222222222222222222
2222222200000222222222222222222222222222222222222222222222222222
2222222220000022222222222222222222222222222222222222222222222222
2222222222200222222222222222222222222222222222222222222222200002
2222222222222222222222222222222222222222222222222222222222000000
2222222222222222222222222222222222222222222222222222222220000000
2222222222222222222222222222222222222222222222222222222200000000
2222222222222222222222222222222222222222222222222222220000000000
2222222222222222222222222222222222222222222222222222200000000000
